H,H,H,H,H,H,H,H,H,H,H,H,H,H,H
H,1,-1,E,E,E,E,E,E,E,E,E,-1,2,H
H,-1,H,E,E,H,H,E,H,H,E,E,H,-1,H
H,E,E,H,E,E,E,E,E,E,E,H,E,E,H
H,E,H,E,E,E,E,E,E,E,E,E,H,E,H
H,E,E,H,E,E,E,E,E,E,E,H,E,E,H
H,E,E,E,E,E,E,E,E,E,E,E,E,E,H
H,E,E,H,E,E,E,E,E,E,E,H,E,E,H
H,E,H,E,E,E,E,E,E,E,E,E,H,E,H
H,E,E,H,E,E,E,E,E,E,E,H,E,E,H
H,-1,H,E,E,H,H,E,H,H,E,E,H,-1,H
H,3,-1,E,E,E,E,E,E,E,E,E,-1,4,H
H,H,H,H,H,H,H,H,H,H,H,H,H,H,H
